#############################
#...........................#
#...........................#
#...........................#
#...........................#
#...........................#
#...........................#
#...........................#
#...........................#
#...........................#
#...........................#
#...........................#
#...........................#
#...........................#
#............@..............#
#...........................#
#...........................#
#...........................#
#...........................#
#...........................#
#...........................#
#...........................#
#...........................#
#...........................#
#...........................#
#...........................#
#...........................#
#...........................#
#...........................#
############################# 
